[
  {
    "name": "LEVEL 1-1",
    "timeLimit": 60,
    "retries": 2,
    "grid": [
      [1, 0, 0, 0, 0, 0, 0, 0],
      [0, 0, 0, 0, 0, 0, 0, 0],
      [0, 0, 0, 0, 0, 0, 0, 0],
      [0, 0, 0, 0, 0, 3, 2, 0],
      [0, 0, 0, 0, 0, 5, 6, 0],
      [0, 0, 0, 0, 4, 7, 7, 0],
      [0, 0, 0, 3, 5, 6, 8, 0],
      [0, 0, 2, 4, 8, 0, 0, 0]
    ]
  },
  {
    "name": "LEVEL 1-2",
    "timeLimit": 90,
    "retries": 3,
    "grid": [
      [0, 0, 0, 0, 0, 0, 0, 0, 0, 0],
      [0, 0, 1, 1, 0, 0, 1, 1, 0, 0],
      [0, 2, 2, 0, 0, 0, 0, 3, 3, 0],
      [0, 1, 1, 4, 4, 4, 4, 1, 1, 0],
      [0, 6, 7, 5, 5, 5, 5, 7, 6, 0],
      [1, 1, 1, 1, 1, 1, 1, 1, 1, 1]
    ]
  },
  {
    "name": "LEVEL 1-3",
    "timeLimit": 120,
    "retries": 3,
    "grid": [
      [1, 0, 0, 0, 0, 0, 0, 1],
      [1, 0, 2, 0, 0, 2, 0, 1],
      [1, 0, 1, 3, 3, 1, 0, 1],
      [1, 1, 0, 4, 4, 0, 1, 1],
      [1, 0, 0, 0, 0, 0, 0, 1],
      [1, 6, 5, 7, 7, 5, 6, 1],
      [1, 1, 1, 1, 1, 1, 1, 1]
    ]
  },
  {
    "name": "LEVEL 1-4",
    "timeLimit": 90,
    "retries": 3,
    "grid": [
      [0, 0, 0, 0, 0, 0, 0, 0, 0, 0, 0, 0],
      [0, 0, 0, 0, 0, 0, 0, 0, 0, 0, 0, 0],
      [0, 2, 0, 1, 1, 0, 0, 1, 1, 0, 2, 0],
      [0, 1, 0, 0, 0, 0, 0, 0, 0, 0, 1, 0],
      [0, 0, 3, 0, 0, 3, 3, 0, 0, 3, 0, 0],
      [1, 0, 1, 4, 4, 1, 1, 4, 4, 1, 0, 1],
      [1, 6, 1, 1, 1, 1, 1, 1, 1, 1, 6, 1],
      [1, 1, 1, 1, 1, 1, 1, 1, 1, 1, 1, 1]
    ]
  },
  {
    "name": "LEVEL 1-5",
    "timeLimit": 120,
    "retries": 3,
    "grid": [
      [0, 0, 0, 0, 0, 0, 0, 0, 0],
      [0, 0, 0, 0, 0, 0, 0, 0, 0],
      [0, 0, 0, 2, 2, 2, 0, 0, 0],
      [0, 0, 3, 1, 1, 1, 3, 0, 0],
      [0, 4, 1, 0, 0, 0, 1, 4, 0],
      [6, 1, 0, 0, 0, 0, 0, 1, 6],
      [1, 1, 1, 0, 0, 0, 1, 1, 1],
      [1, 1, 1, 1, 1, 1, 1, 1, 1],
      [1, 1, 1, 1, 1, 1, 1, 1, 1]
    ]
  }
]
