[
  {
    "name": "LEVEL 1-1",
    "timeLimit": 180,
    "grid": [
      [0, 1, 1, 1, 1, 1, 1, 1],
      [1, 1, 0, 0, 0, 0, 0, 1],
      [1, 0, 0, 0, 0, 0, 2, 1],
      [1, 0, 0, 0, 0, 3, 6, 1],
      [1, 0, 0, 0, 4, 5, 7, 1],
      [1, 0, 0, 3, 5, 7, 8, 1],
      [1, 0, 2, 4, 6, 8, 1, 1],
      [1, 1, 1, 1, 1, 1, 1, 0]
    ]
  },
  {
    "name": "LEVEL 1-2",
    "timeLimit": 90,
    "grid": [
      [1, 1, 1, 1, 1, 1],
      [1, 0, 0, 7, 8, 1],
      [1, 0, 0, 5, 6, 1],
      [1, 1, 0, 3, 4, 1],
      [1, 1, 0, 2, 1, 1],
      [1, 1, 0, 1, 1, 1],
      [1, 1, 2, 0, 1, 1],
      [1, 3, 5, 0, 0, 1],
      [1, 6, 7, 0, 0, 1],
      [1, 4, 8, 0, 0, 1],
      [1, 1, 1, 1, 1, 1]
    ]
  },
  {
    "name": "LEVEL 1-3",
    "timeLimit": 120,
    "grid": [
      [1, 0, 0, 0, 0, 0, 0, 1],
      [1, 0, 9, 0, 0, 9, 0, 1],
      [1, 0, 1, 10, 10, 1, 0, 1],
      [1, 1, 0, 11, 11, 0, 1, 1],
      [1, 0, 0, 0, 0, 5, 0, 1],
      [1, 6, 5, 7, 0, 7, 6, 1],
      [1, 1, 1, 1, 7, 1, 1, 1]
    ]
  },
  {
    "name": "LEVEL 1-4",
    "timeLimit": 90,
    "grid": [
      [0, 0, 0, 0, 0, 0, 0, 0, 0, 0, 0, 0],
      [0, 0, 0, 0, 0, 23, 0, 0, 0, 0, 0, 0],
      [0, 9, 0, 1, 1, 0, 0, 1, 1, 0, 9, 0],
      [0, 1, 0, 0, 0, 0, 0, 0, 0, 0, 1, 0],
      [0, 0, 10, 0, 0, 10, 10, 0, 0, 10, 0, 0],
      [1, 0, 1, 11, 11, 1, 1, 11, 11, 1, 0, 1],
      [1, 6, 1, 1, 1, 1, 1, 1, 1, 1, 6, 1],
      [1, 1, 1, 1, 1, 1, 1, 1, 1, 1, 1, 1]
    ]
  },
  {
    "name": "LEVEL 1-5",
    "timeLimit": 120,
    "grid": [
      [0, 0, 0, 0, 0, 0, 0, 0, 0],
      [0, 0, 0, 0, 0, 0, 0, 0, 0],
      [0, 0, 0, 9, 9, 9, 0, 0, 0],
      [0, 0, 10, 1, 1, 1, 10, 0, 0],
      [0, 11, 1, 0, 22, 0, 1, 11, 0],
      [6, 1, 0, 0, 0, 0, 0, 1, 6],
      [1, 1, 1, 0, 0, 0, 1, 1, 1],
      [1, 1, 1, 1, 1, 1, 1, 1, 1],
      [1, 1, 1, 1, 1, 1, 1, 1, 1]
    ]
  }
]