[
  {
    "name": "LEVEL 1-1",
    "timeLimit": 180,
    "grid": [
      [21, 0, 0, 0, 0, 0, 0, 0, 0, 41],
      [11, 0, 0, 0, 43, 0, 0, 0, 6, 0],
      [2, 3, 4, 5, 0, 7, 8, 9, 10, 0],
      [1, 1, 1, 1, 1, 1, 1, 1, 1, 0],
      [23, 0, 0, 8, 0, 0, 8, 0, 0, 0],
      [0, 0, 0, 1, 0, 0, 1, 0, 0, 0],
      [0, 0, 0, 0, 0, 40, 0, 0, 0, 0],
      [30, 0, 34, 0, 42, 0, 0, 33, 0, 0],
      [1, 32, 0, 0, 0, 0, 0, 0, 31, 0],
      [0, 0, 0, 0, 0, 0, 0, 0, 0, 20]
    ]
  },
  {
    "name": "LEVEL 1-2",
    "timeLimit": 90,
    "grid": [
      [0, 0, 0, 0, 0, 0, 84, 0, 0, 0, 0, 0, 0],
      [0, 0, 0, 0, 0, 0, 1, 84, 0, 0, 0, 0, 0],
      [0, 0, 0, 0, 0, 0, 0, 1, 83, 0, 0, 0, 0],
      [81, 0, 81, 0, 82, 0, 82, 0, 1, 83, 0, 0, 0],
      [1, 1, 1, 1, 1, 1, 1, 1, 1, 1, 0, 0, 0],
      [0, 0, 0, 0, 75, 0, 75, 0, 0, 0, 72, 30, 0],
      [0, 0, 0, 0, 74, 0, 74, 0, 0, 0, 82, 1, 0],
      [0, 0, 0, 0, 73, 0, 73, 0, 0, 0, 81, 0, 0],
      [71, 0, 71, 0, 72, 0, 72, 0, 85, 85, 71, 0, 31],
      [1, 71, 1, 1, 1, 1, 1, 1, 1, 1, 1, 0, 0]
    ]
  },
  {
    "name": "LEVEL 1-3",
    "timeLimit": 180,
    "grid": [
      [0, 0, 0, 0, 72, 0, 0, 0, 0, 0, 0, 0, 0],
      [0, 0, 0, 0, 71, 0, 0, 0, 0, 0, 0, 0, 0],
      [0, 0, 0, 0, 11, 0, 0, 0, 0, 0, 0, 0, 0],
      [0, 0, 0, 0, 10, 0, 0, 0, 0, 0, 0, 0, 0],
      [0, 0, 0, 0, 8, 0, 0, 0, 0, 0, 0, 0, 0],
      [2, 0, 0, 0, 9, 0, 0, 0, 0, 0, 0, 0, 0],
      [32, 0, 0, 0, 7, 0, 0, 0, 0, 0, 0, 0, 8],
      [0, 0, 0, 0, 22, 0, 0, 0, 0, 0, 0, 0, 23],
      [0, 0, 0, 0, 0, 0, 0, 0, 0, 0, 0, 0, 0],
      [0, 0, 0, 0, 1, 0, 0, 0, 0, 0, 0, 0, 0]
    ]
  }
]