[
  {
    "name": "LEVEL 1-1",
    "timeLimit": 180,
    "grid": [
      [21, 0, 0, 0, 0, 0, 0, 0, 0, 41],
      [11, 0, 0, 0, 43, 0, 0, 0, 6, 0],
      [2, 3, 4, 5, 0, 7, 8, 9, 10, 0],
      [1, 1, 1, 1, 1, 1, 1, 1, 1, 0],
      [23, 0, 0, 8, 0, 0, 8, 0, 0, 0],
      [0, 0, 0, 1, 0, 0, 1, 0, 0, 0],
      [0, 0, 0, 0, 0, 40, 0, 0, 0, 0],
      [30, 0, 34, 0, 42, 0, 0, 33, 0, 0],
      [1, 32, 0, 0, 0, 0, 0, 0, 31, 0],
      [0, 0, 0, 0, 0, 0, 0, 0, 0, 20]
    ]
  },
  {
    "name": "LEVEL 1-2",
    "timeLimit": 90,
    "grid": [
      [0, 0, 0, 7, 8],
      [0, 0, 0, 5, 6],
      [0, 0, 0, 3, 4],
      [0, 0, 0, 2, 1],
      [0, 0, 0, 1, 1],
      [1, 1, 0, 0, 0],
      [1, 3, 0, 0, 0],
      [5, 2, 0, 0, 0],
      [6, 7, 0, 0, 0],
      [4, 8, 0, 0, 0]
    ]
  }
]